1,1,1,1,1,1,1,1,1,1,1,1,1,1,1,1,1
1,0,0,0,0,0,0,0,0,0,0,0,0,0,0,0,1
1,1,1,1,1,1,1,1,1,1,1,1,1,1,1,1,1
1,2,1,4,2,0,0,4,1,4,0,2,3,0,1,0,1
1,0,1,1,2,1,0,1,1,1,0,1,2,1,1,0,1
1,2,2,0,3,2,0,3,6,5,2,4,0,0,4,4,1
1,0,1,1,0,1,3,1,1,1,4,1,5,1,1,5,1
1,2,0,0,0,0,5,1,1,1,4,0,0,0,0,5,1
1,3,1,1,2,1,5,1,1,1,5,1,0,1,1,6,1
1,0,0,0,4,4,2,4,3,4,2,6,6,0,0,0,1
1,0,1,1,2,1,3,1,1,1,0,1,3,1,1,0,1
1,5,1,4,6,4,2,4,1,0,0,5,4,5,1,5,1
1,0,1,6,1,1,1,4,1,5,1,1,1,0,1,0,1
1,0,0,6,6,0,4,0,0,0,2,3,0,6,0,0,1
1,1,1,1,1,1,1,1,1,1,1,1,1,1,1,1,1
